6 7 
XXX#XXX
X#X#XXX
XXX#XXX
####XX#
XXXXX#X
XXXXX##
