6 12
XXXXXXXXXXXX
X##########X
X#X#X#X#XX#X
X#X#X#X#XX#X
X##########X
XXXXXXXXXXXX
